0706
#######
#.....D
#..BBP#
#..BBB#
#.....#
#######
