1607
#####D##########
#TT...D##......#
#TT...###...C..#
#.....#S#......#
####...........#
#....#...#######
########D#######